1111111111
1P000C0001
100C0000E1
1000000C01
1111111111
