1111111111
1100000011
1P1C1111E1
1100000001
1111111111
1111111111
