1111111111
1PCCCCCC11
111C1111E1
11CCCCCCC1
1100000CC1
1C000000C1
1111111111
