1111111111
1000000011
100C1111E1
1100000001
1000000001
1P00000001
1111111111
