11111111111111111111111
1EC0C0C0C0C0C0C0C0C0C01
1C0C0C0C0C0C0C0C0C0C0C1
10C0C0C0C0C0C0C0C0C0C01
1C0C0C0C0C0C0C0C0C0C0C1
10C0C0C0C0C0C0C0C0C0C01
1C0C0C0C0C0C0C0C0C0C0C1
10C0C0C0C0C0C0C0C0C0C01
1C0C0C0C0C0C0C0C0C0C0C1
10C0C0C0C0C0C0C0C0C0C01
1C0C0C0C0C0C0C0C0C0C0C1
10C0C0C0C0C0C0C0C0C0C01
1C0C0C0C0C0C0C0C0C0C0C1
10C0C0C0C0C0C0C0C0C0CP1
11111111111111111111111
